В рамках какого философского направления сущность всего считается непознаваемой	Агностицизм
Слово "философия" переводится как	Любовь к мудрости
В рамках какого философского направления реальносить признается существующей вне и независимо от сознания человека	Объективизм
Философская наука о познании - это	Гносеология
Философская наука о бытии - это	Онтология
Философская наука о ценностях - это	Аксиология
В рамках гносеологии философы не занимаются	Выработкой моральных норм, целей, идеалов поведения
Когда возникла философия	В 1 тыс. до н.э.
Тип мировоззрения, который сложился исторически первым	Мифологический
Тип мировоззрения, не относящийся к теоретическому	Обыденный
Тип мировоззрения, формирующийся в результате осознанной деятельности по осмыслению мира	Философский
В рамках какого типа мировоззрения происходит "удвоение мира" на естественный и сверхестественный	Религиозного
Тип мировоззрения, основывающийся на деятельности воображения	Мифологический
Тип мировоззрения, доминирующий в эпоху Нового времени	Научный
Антидогматический тип мировоззрения, в рамках которого вырабатываются одновременно знания и ценности	Философский
Основная проблема, решавшаяся философами милетской школы	Проблема первоначала
Анаксимен за первооснову всех вещей принимал	Воздух
Источник происхождения всего сущего - некое бесконечное, "нестареющее" начало в представлении Анаксимандра	Апейрон
Атомы движутся в пустом пространстве хаотично, сталкиваются и вследствии соответствия форм,размеров, положений и порядков либо сцепляются либо разлетаются. Так полагал	Демокрит
Гераклит полагал, что начало всего сущего	Огонь
Понятие "Логос" в философском учении Гераклита означает:	Всеобщий закон,действию которого подчинено все в мире
Помимо Бытия нет ничего. Мышление и мыслимое есть Бытие, ибо нельзя мыслить ни о чем. Так полагал	Парменид
Идея о том, что знание есть припоминание принадлежит	Платону
Метод вопросов, предполагающий помощь собеседнику в осознании сути добродетели и мудрости	Майевтика
Все сущее происходит и состоит из двух основных начал - "формы" и "материи"	Аристотель
Отметьте школу, в которой сократовская диалектика из орудия отыскания объективной истины превратилась в эристику - искусство спора	мегарики
Цель проповедуемого ими образа жизни - автаркия - "самодостаточность". Так полагали представители школы	киников
Счастье - это отсутствие страха и страдания. Так полагали представители школы	эпикурейцев
Цель проповедуемого ими образа жизни - "атараксия" - бесстрастие. Так полагали представители	стоической школы
Не плакать, не смеяться, а понимать - это идеал	стоический
Предпочитали отрицательную теологию, согласно которой ни один атрибут, понятный нашему уму, нельзя приписать Богу, ибо он бесконечно далек, совершенен и велик	неоплатоники
Видел цель философии во спасении души	Порфирий
Мировоззренческий принцип, согласно которому мир сотворен Богом из ничего, называется	Креационизм
Сотериология
Принцип, согласно которому Бог определяет весь ход истории и судьбу каждого человека	Провиденциализм
Главная задача христианских апологетов состояла	В обосновании преимуществ христианства перед язычеством
Название периода творческого служения «отцов Церкви» (III-VIII вв.), заложивших основы христианской философии и богословия; в их трудах в противостоянии-диалоге с греко-римской философией идет формирование системы христианской догматики	патристика
Выдающийся представитель патристики, автор книг «Исповедь», «О Граде Божьем»	Августин
Схоластика это	тип философствования, отличающийся умозрительностью и приматом логико-гносеологических проблем
«Верую, ибо абсурдно» - формула, которой можно выразить соотношение веры и знания, как его понимал	Тертулиан
Считали универсалии реально существующими, причем существование универсалий, предшествует существованию остальных вещей представители	реализма
Предвосхитил экспериментально-математический метод исследования природы	Леонардо да Винчи
Автором априорного доказательства является	Ансельм Кентерберийский
Апостериорное доказательство - это доказательство, которое исходит из	опыта
Подчеркивают значимость и определяющую роль в Богопознании необъективируемого духовного опыта	мистики
Разрабатывал так называемую «метафизику света» и теорию «зародышевых доказательств»	Бонавентура
"Единое есть все" - эта формула	неприемлима для христианского теизма
Система взглядов, которые стремятся к отождествлению понятий "бог" и "природа" носит название	пантеизм
Разрушил важнейший принцип аристотелевской физики и космологии, отвергая вместе с ним и представление о конечности космоса	Николай Коперник
Метод рассуждения от частного к общему	Индукция
Метод умозаключения от общего к частному	Дедукция
Основателем эмпиризма традиционно считают	Ф. Бэкона
Выражение «нет ни одного понятия в человеческом уме, которое не было бы порождено первоначально, целиком или частично, в органах ощущения» отражает позицию	эмпиризма
Основное утверждение рационализма заключается в том, что	Разум играет приоритетную роль в познавательной деятельности человека
Что означает исходный тезис философии Декарта, по-латински звучащий как «cogito ergo sum»	если я мыслю, следовательно, я существую
Мысль «никогда не принимать за истинное нечто, что я не познал бы таковым с очевидностью» принадлежит	Р. Декарту
Основным методом научного познания, по мнению Ф. Бэкона, должна стать	Индукция
Философ, считавший, что сознание ребенка подобно чистой доске tabula rasa	Дж. Локк
Причинности как порождения одного другим, по мнению этого мыслителя, в нашем чувственном опыте нет, а в нем есть лишь следование одного за другим во времени. Этим мыслителем является	Д. Юм
В вопросе о субстанции Рене Декарт придерживался позиции	Дуализма
Б. Спинозе
Простая неделимая субстанция согласно Лейбницу	Монада
Внешний мир существует независимо от восприятий, бытие вещей состоит в их воспринимаемости - полагал	Дж.Беркли
Центром европейского Просвещения в середине 18-го века была	Франция
“Если бы бога не существовало, его следовало бы выдумать” – этой крылатой фразой не только критикует, но и предупреждает об опасности атеистического общества великий французский философ	Вольтер
Причиной неравенства в человеческом обществе Ж.-Ж. Руссо считал	Собственность
Кто из немецких классических философов является агностиком?	Кант
Кто "разбудил Канта от догматического сна"	Юм
Что лежит в основе развития, по Гегелю	Субстанция-субъект
Что означает термин "априорное"	Доопытное
К какому направлению философии принадлежит Гегель?	Идеализм
На чью философию опираются большинство современных мыслителей	Канта
С каим философом не согласно большинство современных мыслителей?	С Гегелем
Над чем размышляет разум, по Канту	Над идеями
Формы, в которых мыслит рассудок, по Канту	Категориии
Формы чувственности, по Канту	Пространство и время
Автор философии абсолютного тождества	Шеллинг
Создатель теории "наукоучения"	Фихте
Принципом наукоучения является	"Абсолютное Я"
Философ, утверждающий наличие развития в природе	Шеллинг
Чьи мысли продолжает развивать Фихте в своем учении	Канта
С чем Фихте отождествляет Я	С сознанием
Кто из немецких клаассических идеалистов является субъективистом	Фихте
Человек в неклассической философии 19 века рассматривается как	Существо, практически преобразующее реальность
Диалектика мышления есть ни что иное, как отражение в сознании людей объективной диалектики, то есть развития и связей самой природы и общества, - такая идея высказывается в философии	К. Маркса
Центральной категорией марксизма является понятие	Практики
Процесс исторического развития рассматривается как поэтапное снятие социального отчуждения и возрастание степени свободы человека в обществе в философии	К. Маркса
Является абсолютным началом бытия, с точки зрения Артура Шопенгауэра	Воля к жизни
Выход из бесконечной череды жизненных страданий согласно воззрениям А.Шопенгауэра состоит в	Подавлении в себе воли к жизни, любой активности
Необузданное, страстное, иррациональное, не имеющее никаких закономерностей и не ограниченное рамками стремление, идущее из недр самой жизни, Ницше называет	Дионисийским началом
Философия Сократа, с точки зрения Ф. Ницше - это средство	навязать миру логические схемы
Настаивает на том, что философия принципиально отличается от науки, что она напрямую зависит от субъективной, личной жизни философа.	С. Кьекегор
Исходной точкой для достижения истины С. Кьекегор называет	Отчаяние
Комплекс вопросов о сущности и строении разума, который был одновременно и вопросом о сущности и строении мира, становится главной темой	в классической философии
Отказывается от претензий на систематическую целостность при конструировании картины реальности, на способность разума постичь эту реальность, веру в естественную упорядоченность и разумность мира, на наличие в нем внутренней логики	Неклассическая философия
Начинается переход к жесткой постмодернистской атаке на сами основания понимания природы философского знания

на этапе постнеклассической философии
Мыслят философию исключительно как науку, полагают, что она должна строиться по типу любой другой “позитивной” науки и отвечать всем критериям научности	сторонники сциентизма
Отстаивают принципиальную несовместимость философского и научного подходов к миру и жизни	сторонники антисциентизма
Философия должна быть не размышлением о началах бытия, не рациональной формой его познания, а общим методом решения проблемы практической деятельности людей, причем главным в этой деятельности представляется ее результативность, - такова суть концепции	прагматизма
Полагает, что положения науки, должны рассматриваться подобно любым верованиям, как привычки или готовность действовать	Ч.Пирс
К основным направлениям современной философии не относится	Сенсуализм
Современную философию не интересуют вопросы, связанные с	поиском истины
Какое направление современной философии занимается истолкованием текстов	Герменевтика
Какое направление современной философии занимается исследованием бессознательного	Психоанализ
Какое направление современной философии занимается проблемами человеческого бытия	Экзистенциализм
Какой элемент доминирует в психике, по Фрейду	Бессознательное
Какой из элементов психики,по Фрейду, занимается различением реального и воображаемого	Сознание
Какой из элементов психики, по Фрейду, осуществляет репрессивные функции, мучая человека угрызениями совести	Сверхсознание
Кто из перечисленных ниже философов не является экзистенциалистом	Гадамер
Основной отличительной чертой человека, согласно экзистенциалистам, является	Наличие свободы
К неофрейдистам не относится	Ж.-Ф. Лиотар
Автор понятия "Коллективное бессознательное "	К.Г. Юнг
В рамках неофрейдизма	Большое внимание удиляется анализу межличностных отношений
К постмодернистам не относится	Э. Фромм
Мир в рамках философии постмодернизма предстает	непознаваемым
Что такое ризосома в философии постмодернизма	Символ неупорядоченности мира
Человек в рамках философии постмодернизма осуществляется в процессе	Игры
Бытие это	все то, что существует тем или иным способом
Сущность - это	Качественная определенность вещей
Существование это	внешнее бытие вещей
Парменид характеризует бытие как	единое и неделимое
Демокрит отождествляет бытие с	атомами
Идеализм - это философское направление, которое исходит из	идеи о том, что основа мира нематериальна
Свойство это	способность вещи определенным образом соотноситься с другими вещами
Система это	комплекс взаимосвязанных элементов
Материя это	Объективная реальность, существующая вне и независимо от сознания
Учение о бытии называется	онтология
Небытие - это	отсутствие наличного, качественно определенного существования
Субстанция - это	неизменная, неуничтожимая основа бытия
Что обеспечивает бытие/существование вещи	устойчивые связи между ее частями
Пространство - это	протяженность
Время - это	длительность
Движение - это	любая перемена состояния вещи
Каким тезисом можно выразить универсальность движения	быть - значит сохранять определенные состояния при постоянных изменениях
Большинство исследователей отмечают, что самостоятельное творчество в области философии обнаруживается в России	Во второй половине 18 века
Показал, чем отличается развитие России от развития Запада, и выдвинул идею о том, что русские могут строить свое будущее, используя исторический опыт народов Европы, и могут избежать их ошибок, повинуясь голосу просвещенного разума в своей работе «Философические письма»	П.Я. Чаадаев
Выступали за преодоление отсталости России, выражавшейся в реликтах патриархального общественно-экономического и нравственного уклада (выделите 2 ответа)	Белинский и Грановский
Указывали на самобытный характер развития российского общества и его культуры, основой самобытности России и русской культуры считали православие, которое, будучи прямым продолжателем традиций византийской патристики, в гораздо большей степени, чем западные католицизм и протестантизм, сохранило чистоту христианской веры (выделите 2 ответа)	Хомяков и Самарин
Термин «соборность» в философии славянофилов обозначает	Свободное духовное единение людей в церковной жизни
Оформление «русской идеи» через понимание, что Россия как крупнейшее государство должна стать инициатором и главной опорой духовного объединения христианства принадлежит	Соловьеву
Был подчинен оправданию мира, включающего материальный космос и здешнее бытие с его хозяйственной деятельностью и исторической реальностью, далекой от совершенства, основной пафос религиозно-философских исканий	Булгакова
Отцом русского космизма чаще всего называют	Николая Федоровича Федорова
Свобода истолковывается не как врожденная, природная или социальная способность человека, а как первичная и фундаментальная реальность, проникающая во все сферы бытия – космос, общество и самого человека	Николаем Александровичем Бердяевым
Занимался в основном проблемами социальной теории и практики: разработал теорию империализма как высшей стадии капитализма, теорию социалистической революции	Владимир Ильич Ульянов(Ленин)
В трудах многих русских философов, таких как С.Н. Булгаков, П.А. Флоренский, С.Л. Франк, присутствует идея синергии, суть которой	В сотрудничестве Бога и человека в деле преобразования материального мира
Культурно-общественное движение русской эмиграции 20–40-х годов XX века, которое признавало самобытный путь развития России, обусловленный наличием в ее культуре откровенно восточных элементов.	Евразийство
Истинный национализм с точки зрения Н.С. Трубецкого	основан на признании необходимости самобытной национальной культуры
Философская концепция, развивающая комплекс представлений о гармоническом единстве человека и вселенной, о их своеобразной взаимозависимости и взаимопроникновении, а также о средствах достижения такого состояния	антропокосмизм
«Общее дело» с точки зрения великого русского мыслителя Н. Ф.Федорова состоит (выберите 2 ответа)	во всеобщей регуляции природы,управлении ее силами и в воскрешении предков
Настаивал на применении к человеку искусственного отбора, с целью совершенствования человечества в целом	Константин Эдуардович Циолковский
Представителем философии русского космизма и автором концепции "ноосферы" является	Владимир Иванович Вернадский
Изменения, которые не затрагивают сути предмета	Внешние
Если новое, появившееся в процессе развития, качественно отличается от исходного большей жизнеспособностью, гибкостью, сложностью, способностью к дальнейшему развитию, богатством реализо-ванных возможностей, то можно говорить о том, это	прогрессивное развитие
Системный эффект, возникающий при усложнении организа-ционной структуры, проявляющийся в том, что в системе появляется новое свойство, не присущие элементам этой системы -	эмерджентность
Эмерджентная концепция развития сложилась в работах	Сеэмюэль Александер Морган Конви Ллоид
Исходит из допущения принципиальной возможности спонтанного возникновения порядка из хаоса, делает акцент на нестабильности открытых систем, многообразии путей их изменения и развития, условиях устойчивого развития сложных структур


синергетика
К основным принципам диалектики относят	принцип всеобщей связи; принцип становления; принцип историзма
Выдвинул идею открытой системы категорий	Гегель
Категория, которая служит для обозначения целостности свойств предмета, необходимых и достаточных для его существования категория	качества
Настаивает на неизменности определенного корпуса истин, а новация рассматривается как подрывающая основы знания и вообще порядка	Догматика
Подход, берущий свое начало от античных софистов, основанный на предположении о том, что нет абсолютной истины, есть разная по силе убеждения аргументация –	софистика
В неклассической философии преобладает	Тьер де Шарден
Обосновал понятия биосферы (сферы биологической жизни) и ноосферы (совокупности человеческих идей и их материализаций в технике и «теле цивилизации»)	Вернандский
Природа, чтобы развиваться, должна быть единственной, самодостаточной, суверенной, нет потусторонних, нематериальных сфер и миров, руководящих миром материальным – это положение выражает суть принципа	Материального единства мира
Высшие психические функции человека (речь, самосознание, логическая память и др.) возникаю не в результате развития биологически заданных, «врожденных способностей», «талантов», .. а в результате воспитания в системе общества, - так полагал	Выготский
Научная деятельность человека является результатом развития поискового рефлекса животных, «рефлекса что такое», - так полагал	Павлов
Живое имеет специфическую сущность и закономерности, и изучаться оно должно особыми, несводимыми к физике и химии методами, - так полагал	Анохин
Что значит, что диалектика атрибутивна человеческому мышлению	Изначальна присуща человеческому мышлению
Сознание - это	Высший уровень духовной активности
Формы отражения в живой природе	раздражимость,чувствительность,психика,сознание
Психика характеризуется	Способностью к опережающему отражению
Материальной основой сознания является	мозг
Мышление это	функция сознания, выражающаяся в формировании понятий и оперировании ими
Язык это	система знаков, выступающих связующим звеном между мышлением и миром
Эмоциональная сфера сознания включает в себя	аффекты,настроения и элементарные эмоции
Самосознание это	целостность компонентов внутреннего и внешнего опыта человека
Единственный метод изучения самосознания согласно У.Джеймсу	ретроспективный
Носителями общественного сознания являются	любые социальные группы
Дух - это	объективно-идеальное начало
Вера это	нравственно-эмоциональный акт, связанный с целостно-смысловой структурой сознания
Ментальность - это	внутренние структуры восприятия и мышления
Эволюционные пласты структуры головного мозга	R-комплекс, подкорковые структуры,кора больших полушарий
Информация - это	Уменьшение неопределенности в отношении взаимодействующих материальных систем
Идеальное (в онтологическом смысле) - это	противоположность материального
Знак - это	материальный носитель информации
Создает систему, в которой истина - это поступательное развитие разума, а противоречие - необходимый момент	Гегель
Философско-мировоззренческая позиция, заключающаяся в критическом отношении у науке, ее положению в культуре и ее возможностям познания	Антисайентизм
Отрицает полностью возможность познания истины	Агностицизм
Целостное отражение предметов в результате их непосредственного воздействия на органы чувств называется	восприятием
Форма мышления, демонстрирующая отношения между двумя и более классами предметов или признаков	суждение
Истина есть интенциональное согласие интеллекта с реальной вещью или соответствие ей. Так понимается истина	в корреспондентной теории истины
Истинными знаниями будут те, которые надёжно, эффективно, успешно «работают»: ведут человека к успеху, полезны для него, утверждает	прагматическая теория истины
Прагматическую теорию истины развивали в своих работах	Чарльз Сандерс Пирс; Уильям Джеймс; Джон Дьюи
Экзистенциальную теорию истины развивали в своих работах	Сартр; Камю
Утверждает, что истинность знания не в том, что оно соответствует действительности, а в том, что оно является самосогласованным, логически связанным, непротиворечивым	когерентная теория истины
Некритическое восприятие информации, субъективистские его интерпретации, обусловленные пристрастиями, оценочными предпочтениями и интересами, составляют специфику	мнения
«Сомнение приходит после веры»; развитая форма познания — научное познание — также покоится на вере в некоторые эмпирические высказывания, - так рассматривал соотношение веры и знания	Виткенштейн
Когда вера доведена до достоверности, она разрушается, тогда это уже более не вера, а знание, - так полагал	Локк
Называет «предрассудком» положение о том, что только знание обладает достоверностью, доказательностью, истинностью	Ильин
«Чем дальше человек стоит от научной лаборатории, тем более он иногда бывает склонен преувеличивать достоверность научных предположений и объяснений. Полуобразованные люди слишком часто верят в «науку» так, как если бы ей было все доступно все» , - так о достоверности научного знания высказывается	Ильин
К познанию мира человека ведет свободное самодвижение «субъективного духа», несущего в себе искру духа абсолютного, так полагал	Гегель
Практикой в диалектико-материалистическом понимании является	Вся совокупность человеческой преобразовательной деятельности
К критериям научности знания не относится	Образность
Вид познавательной деятельности, для которого не характерно стремление к выявлению глубинной сущности	Обыденный
Объект научного познания - это	Действительность в целом
Рецептурный характер носила	Преднаука Древнего Востока
К уровням организации научного знания не относится	Метафизический
На каком уровне происходит выработка научных гипотез	на теоретическом
Для какого уровня характерно применение метода идеализации	для теоритического
Для какого уровня характерно применение метода наблюдения	для эмпирического
На каком уровне происходит создание научной картины мира	на метатеоретическом
Принцип, согласно которому каждое утверждение в науке должно быть подтверждено опытом	принцип верификации
Субъектом науки не может выступать	отдельный этнос
Какое из выражений наиболее точно: каждая из наук имеет свой собственный…	предмет исследования
Предмет познания естественных наук - это	Природа
Эпистемология разрабатывается в рамках	Наук о познании
Группа методов, долгое время доминировавших в науке	естественно-математические
К типам научной рациональности не относится	Постклассический
Какой тип рациональности дольше всего доминировал в науке	классический
Выдвинули требование к философам отказаться от поисков первопричин, которыми занималась бесплодная «метафизика», представители	Первой волны позитивизма
Главной задачей считали создание теории научного познания, которая выражалась, прежде всего, в программе «очищения опыта», представители	Второй волны позитивизма
В основе жизни лежит принцип наименьшей траты сил, а так как познание является аспектом жизни, то этот принцип распространяется и на познавательные процессы, в познании он выступает в форме принципа экономии мышления, - так полагал	Рихард Авенариус
Принцип, согласно которому только то предложение имеет смысл, которое прямым или косвенным образом допускает сведение к предложениям, обозначающим непосредственный чувственный опыт индивида, или протокольным предложениям ученого (фиксация опыта в предложении), - носит название принципа	Верификации
Предложил «принцип терпимости», согласно которому можно выбирать ("терпеть") любую избранную решением субъекта непротиворечивую логическую систему	Рудольф Карнап
Полагал, что развитие научного знания происходит в результате конкуренции научно-исследовательских программ, составляющих "Внутреннюю историю" науки	Имре Лакатос
Провозгласил замену принципа верификации принципом фальсификации	Поппер
Развитие науки, происходит через периодическую коренную трансформацию и смену ведущих научных представлений и техники исследования (парадигм), т.е. через периодически повторяющиеся научные революции, по мнению	Томаса Семюэла Куна
С точки зрения Фейрабенда этот термин призван обосновать плюрализм в методологии научного познания	пролиферация
Приходит к выводу, что познание представляет собой скорее возрастающий океан взаимно несовместимых (и, может быть, даже несоизмеримых) альтернатив, в котором каждая отдельная теория, каждая волшебная сказка, каждый миф являются частями одной совокупности, взаимно усиливают, дополняют друг друга и благодаря конкуренции вносят свой вклад в развитие нашего сознания.	Фейерабенд
Направление в западной философско-гносеологической мысли, основная задача которого — выявление генезиса и этапов развития познания, его форм и механизмов в эволюционном ключе и, в частности, построение на этой основе теории эволюции науки.	эволюционная эпистемология
Принцип возрастания и инвариантности знания под влиянием изменений условий опыта лежит в основе	генетической эпистемологии
Считает, что развитие знания происходит путем постепенного добавления новых положений к накопленной сумме знаний	кумулятивизм
Полагает, что в ходе развития познания не существует каких-либо устойчивых (непрерывных) и сохраняющихся	аккумулятивизм
Характеризовалась возникновением теории относительности и квантово-полевой картины мира	вторая научная революция
Учитывает связи между знаниями об объекте и характером средств и операций деятельности	неклассический тип рациональности
Расширяет поле рефлексии над деятельностью, учитывает соотнесенность получаемых знаний об объекте не только с особенностью средств и операций деятельности, но и с ценностно-целевыми структурами.	постнеклассический тип рациональности
Общество - это	устойчивая система связей и отношений между людьми
К социальным функциям человека относятся	труд и сознания
Техномасса - это	все то, что создано человеком, включая растения и животных
Во взаимосвязи человека и общества, человек является	предпосылкой и результатом социальных отношений
Что побуждает человека к взаимодействию с другими людьми	потребности в определенных условиях существования
"Социальный атом" - это	группа людей,находящихся в непосредственном визуальном контакте
Общественные отношения по своей природе бывают	материальными и духовными
Политическая подсистема общества включает	социальные группы, общественные организации, политические институты, государство
Уровни общественного сознания	обыденный и теоретический
Социальная психология - это	эмоционально окрашенное отношение и оценка различных социальных процессов
Предметом социальной философии является	особый вид реальности, отличный от природы и жизни отдельных индивидов
К основаниям существования и функционирования общества относятся	природные условия, интерсубъективность, духовность
С точки зрения субъективного идеализма основой общественных отношений является	Сознание людей
Движущими силами материального производства являются	производительные силы и производственные отношения
Социальный институт это	вид социальной деятельности, определяемый нормами и установками
Государство - это	аппарат управления обществом посредством реализации отношений власти
Цивилизация - это	воплощение культурных ценностей преимущественно в материальных формах
Основанием для изменений полагает не экономику, чаще всего технико-технологический базис полагают	сторонники стадиально-цивилизационной модели развития общества
К сторонникам стадиально-цивилизационной модели развития общества относятся	Ясперс; Ростоу
К сторонникам локально-цивилизационной модели развития общества относятся	Данилевский; Тоинби
Пятью культурными типами: западным, православно-христианским, исламским, индуистским и дальневосточным представлен цивилизационный период в творчестве	Тоинби
Исходят из того, что существуют отдельные цивилизации, большие исторические общности, которые занимают определённую территорию и имеют свои особенности социально-экономического, политического и культурного развития, сторонники	Локально-цивилизационной модели развития общества
Теории о линейном характере развития общества впервые появляются	В эпоху Средневековья
В применении к обществу ризосома символизирует	хаотичность и отсутствие какой-либо определенной направленности социальных процессов
В философский дискурс ввели термин Ризосома	Делез; Гваттари
Мир в целом, и общественная жизнь людей представляет собой совокупность огромного множества явлений, «единой истории человечества нет, а есть лишь бесконечное множество историй, связанных с разными аспектами человеческой жизни», - эта положение выражает позицию	антиисторизма
К сторонникам антиисторизма относятся	Хайек;Мизес
А. Шопенгауэр, Ф. Ницше, многочисленные представители экзистенциализма, сторонники	идеи регрессивного развития
Трактует человеческую историю как неравномерное изменение этносов, детерминированное пассионарностью молодых, творческих, заряженных избыточной энергией общностей, борющихся за жизненное пространство со старыми, находящимися на стадии нисхождения в силу доминирования в их структуре субпассионариев	Гумилев
Экстраполировал идею экономической цикличности и длинных экономических волн на социокультурную реальность	Сорокин
Главной опасностью для общности в постсовременном мире становится	ее информационная отсталость
Характеризует общность с точки зрения способа ее взаимодействия с внешним миром и означает свободу перемещения людей, товаров, сырья, финансов, идей и вообще любых материальных и духовных ценностей	открытое общество
В эпоху глобализации главным средством ресурсного обеспечения людей как в сфере взаимодействия с природой, так и в сфере отношений друг с другом	научно-технический прогресс
Автором интеллектуальной конструкции о конце истории является	Фукуяма
Макрокосм - это	Вселенная
Традиционно человек рассматривается как единство	тела души и духа
Душа человека - это	переживания, эмоции и мысли человека
Дух человека - это	сфера высших, неутилитарных ценностей
Предметом философской антропологии является	сущность человека как особого рода бытия
Причина, по которой невозможно создать общее (синтетическое) учение о человеке, собрав все существующие представления о нем	принципиально разные предпосылки этих представлений
Природные основания человека	особые анатомо-морфологические признаки и длительный период детства
Культурные основания человека	способность к созданию символических систем
Суть антропологического кризиса	Отсутствие единой идеи человека
Роль СМИ в антропологическом кризисе	формирование толпы, массы, наблюдающей события со стороны и не несущей ответственности за эти события
С точки зрения марксистско-ленинской философии, человек - это	биосоциальная система
Человек природный - это	абстракция, имеющая реальные основания
По мнению Ж.-Ж. Руссо, отношение между природным и социальным в человеке следующее	чем меньше в человеке социальности, тем больше в нем истинно человеческого
С точки зрения марксистско-ленинской философии, отношение между природным и материальным таково	человек - часть общества, но общество не исчерпывает всего человека
Три измерения бытия человека	человек природный;социальный;духовный
Фактор, интегрирующий биологическую и социальную ипостаси человека	культура
Что является главным признаком самостоятельности личности	Ответственность
Герменевтика это	искусство толкования текстов
Один из принципов герменевтики	необходимостьвыявить замысел автора
Идея В. Фон Гумбольдта, изменившая представление о языке	язык является самостоятельным началом, создающим, а не отражающим реальность
Суть критики языка философом-экзистенциалистом М. Хайдеггером:	современный язык является неподлинным в силу своей формализованности, связанности логикой и грамматикой
Характеристика языка, на которую указыввал родоначальник феноменологии Э. Гуссерль	конвенциальность и, как следствие, относительность
Согласно швейцарскому лингвисту Ф. де Соссюру, речь, в отличии от языка, представляет собой	свободный акт человеческого творчества
Семиотика - это	теория знаков и знаковых систем
Техника - это	любое техническое устройство или прием, помогающие сделать действия человека эффективными
К какому типу систем относятся технические обьекты	естественно-искусственные системы
К иллюзиям по поводу техники относится утверждение о том, что	техника является нейтральной по отношению к человеку
Предметом изучения философии техники является	Феномен техники в целом, внутренние законы ее развития и место в общественной жизни
В чем состоит смысл техники с точки зрения деятельностного подхода	в усилении органов человека и возможностей его деятельности
Принципы, лежащие в основе создания технических средств	принцип функционального моделирования и принцип дополнительности
Технический прогресс - это	последовательное преобразование трудовых функций человека в функции технических средств
Идея, лежащая в основе технического пессимизма	техника - разрушительная сила, порождающая общественные проблемы, разрушение социальности
Какой тип законов реализуется в технике	природные и социальные законы
В чем проявляется один из аспектов относительной самостоятельности техники	техника проявляет неожиданные социальные свойства, не входившие в цели изобретателей
Отвергает общее для антиисторизма непозитивистов и крит рационалистов	томас кун
комплекс элементов с устойчивыми связями между ними	системой
системность это	один из критериев научности
одной из форм научного познания не является	индукция
филосов, считавший, что сознание ребенка подобно чистой доске tabula rasa	Дж. Локк
фактор интеграции его биологической и соц ипостасей
опровержение; ложное; несогласующееся с общепринятым; погрешность речи … софисты	аристотель
с позиции объективизма	мир существует независимо от воспринимающего субъекта
по общественному договору человек, как полагает Ж.Ж. Руссо, теряет свою естественную свободу, а приобретает	свободу гражданскую
в статье "Героиз и подвижничество	С.Н. Булгаков
язык представляет собой	систему знаков, организованную и функционирующую по опред правилам
способность к опережающему отражению обеспечивается	психикой
мыслится как всеединая, нелинейная, самоизменяющаяся	глобальный эволюционизм
"верую, ибо абсурдно" - формула, которой можно выразить соотношение веры и знания, как его понимал	Тертулиан
единое есть все это формула	неприемлима для христианского теизма
единая научная картина мира, объединяющая живую и неживую природу	современной науки
автором этнокосмологической гипотезы историко-культурного процесса	лев николаевич гумилев
социальная деятельность, определяемая нормами и установками, носит общее название	социальный институт
как верное средство обратить человека к познанию своей души	сократом
философия наука о познании	Гносеология
способность к созданию сиволических систем явл	одним из культурных оснований чел бытия
представителем особого иррационалистического направления в философии	анри Бергсон
одной из направлений современной философии	Герменевтика
опирается на понимание - обнаружение смысла посредством интерпретации	герменевтика
качественная определенность вещей это	сущность
проблема интерпретации текстов разрабатывается в рамках	Герменевтика
чье учение представляет собой развитую диалектическую систему	гегеля
в неклассической философии преобладает	аксиологическая проблематика
"сомнение приходит после веры " развитая	Л. Виткенштейн
в концепции томаса куна исследование, опирающееся на одно или несколько прошлых научных достижений носит название	нормальная наука
поход, берущий свое начало от античных софистов, основанный на предположении о том что нет абсолютной истины	софистика
указывает, что основная философема социализма	П.Б. Струве
какой из видов мировоззрения не явл систематизированным	искусство
для эмпирического уровня научного познания не характерно прим метода	идеализации
все, что создано человеком, включая выведенные им растения	техномассу
пока люди живут без общей власти они, с точки зрения т. Гоббса	войны всех против всех
философия наука о бытии	онтология
тип мировоззрения доминирующий в эпоху нового времени	научный
произведением эпохи возрождения, в котором нашло яркое выражение и философское обоснование гуманистическое учение	"речь о достоинстве человека" джовании пика делла мирандолы
чем дальше человек стоит от научной лаборатории, тем более он иногда бывает склонен преувеличивать	И.А. Ильин
способность вещи определенным образом соотноситься с другими вещами	свойство
если бы бога не существовало, его следовало бы выдумать	вольтер
выдвинул программу построения искусственного "идеального" языка	людвиг Витгенштейн
допущение, согласно которому материальны мир, частью которого являемся и мы	постмодернисткого сознания
утверждает, что истинность знания не в том, что оно соответствует действительности	когерентная теория истины
"человек природный", "человек социальный"	три измерения бытия человека
предметом философии является	истина
как одну из черт древнеиндийской философии можно выделить ее	синергетизм
Г. Риккерт, представитель неокантианства, отстаивая свои	философией жизни
длительный период детства необходим человеку для того, чтобы	освоить соц нормы поведения и культурные ценности
характеристикой экзистенциальной ситуации не является	полная предсказуемость последствий выбора
одной из форм научного познания не является	индукция
Лев Николаевич Гумилев определил эффект энергии живого вещества	пассионарность
высшая форма активного отражения является	сознание
внешний мир не существует независимо от восприятий, бытие вещей	Дж. Беркли
к методам научного познания не относится	предсказание
с точки зрения герменевтики, в "ткани" текста переплетаются	смыслы
способ функционирования Вселенной как живого организма, приходящий на смену первобытному Хаосу	дао
отстаивают принципиальную несовместимость философского и научного подходов к миру и жизни	сторонники антисциентизма
объективная реальность, существующая вне и независимо от сознания	материя
автором "этнокосмологической гипотезы"	Лев николаевич гумилев
группа людей, находящихся в непосредственном визуальном контакте, называется	социальный атом
к диалектике прибегают только в том случае, когда нет никакого другого средства	ницше
сфера высших, неутилитарных ценностей человек это сфера	духа
представитель французского механистического материализма	Ж.О. Ламетри
в истории техники различают следующие периоды	период ручных орудий, период мех устройств
в человеке современную философию интересует, прежде всего	внутренний мир
целостность компонентов внешнего и внутреннего опыта человека	самосознание
согласно философии какого мыслителя в основе развития всего сущего лежит субстанция субъект	Гегеля
в философии буддизма Истинной причиной страдания является	жаджа наслаждения
функция сознания, выражающаяся в формировании понятий и оперировании с ними	мышление
сущность человека как особого рода бытия является предметом	философской антропологии
наука о бытии	онтология
одно из направлений современной философии	Герменевтика
тип мировоззрения , который сложился исторически первым	мифологический
искусство толкования текстов	Герменевтика
знак
Определил цель философии как логическое прояснение мыслей	Людвиг Витгенштейн
Счастье – это отсутствие страха и страдания. Так полагали представители школы	эпикурейцев
В статье «Героизм и подвижничество (Из размышлений о религиозной природе русской интеллигенции)», изданной в сборнике "Вехи" в 1909 году называет русскую революцию интеллигентской	С. Н. Булгаков
Когда возникла философия?	В 7-6 в. до н.э.
Любая перемена состояния вещи определяется как	движение
Познание сущности всего невозможно в философии	Канта
Равновесие этноса с ландшафтным и человеческим окружением, т. е. превращение его в реликт, когда он находится в пережиточном (персистентном) состоянии, лишенном творческих сил, Лев Николаевич Гумилев называет	гомеостаз этноса
Цель проповедуемого ими образа жизни —“атараксия” — бесстрастие. Так полагали представители	стоической школы
Протяженность - главный атрибут	пространства
Идея о том, что знание есть припоминание, принадлежит	Платону
В основе технического оптимизма лежит идея	научно-технического прогресса, который разрешит все общественные процессы
Цель проповедуемого ими образа жизни —“атараксия” — бесстрастие. Так полагали представители	стоической школы
Протяженность - главный атрибут	пространства
Системность - это	Один из критериев научности
Счастье – это отсутствие страха и страдания. Так полагали представители школы	эпикурейцев
Уменьшение неопределенности в отношении взаимодействующих систем называется	информацией
В статье «Героизм и подвижничество (Из размышлений о религиозной природе русской интеллигенции)», изданной в сборнике "Вехи" в 1909 году называет русскую революцию интеллигентской	С. Н. Булгаков
Одна из функций научного познания	Объяснение
Воплощение культурных ценностей приемущественно в материальной форме фиксируется в категории	цивилизация
Представитель герменевтического направления в философии	П.Рикер
"Опровержение; ложное; несогласующееся с общепринятым; погрешность в речи и…,принуждение собеседника к пустословию…" определил как цели, которые преследуют софисты	Аристотель
Взрывообразный рост могущества того или иного этноса и смену одних этносов другими за счет воздействия на него космической энергии объясняет	Гумилев
Термин "апостериорное" означает	Полученный в результате опыта
Идея о том, что, если науку ценят за ее достижения, то миф мы должны ценить в сотни раз выше, поскольку его достижения несравненно более значительны	Полю Карлу Фейерабенду
Создал концепцию эпистемологического анархизма	Пол Карл Фейерабенд
Особенность знаков-символов заключается в том, что они	основаны на конвенциональных правилах использования, имеют смысл только в определенных ситуациях
Особая формы бытия, отличная от природы (естественной формы)	общество